room_type
ویلا               22394
آپارتمان           12420
سوئیت               4871
خانه                3457
بوم گردی            3136
کلبه                2468
سوییت               2385
اقامتگاه            1255
اقامتگاه سنتی        991
هتل                  859
مجتمع اقامتگاهی      724
مهمانسرا             398
هاستل                305
مسافرخانه            242
روستایی               69
کاروانسرا             49